  *    *    *    *    *    *    *    *    *    *    *    *    *    *    *    *    *    *    *    *    *    *    *    *    *    *    *    *    *    *    *    *    *    *    *    *    *    *    *    *    *    *    *    *    *    *    *    *    *    *    *    *    *    *    *    *    *    *    *    *    *    *    *    *    *    *    *    *    *    *    *  
  *    *    *    *    *    *    *    *    *    *    *    *    *    *    *    *    *    *    *    *    *    *    *    *    *    *    *    *    *    *    *    *    *    *    *    *    *    *    *    *    *    *    *    *    *    *    *    *    *    *    *    *    *    *    *    *    *    *    *    *    *    *    *    *    *    *    *    *    *    *    *  
  *    *    *    *    *    *    *    *    *    *    *    *    *    *    *    *    *    *    *    *    *    *    *    *    *    *    *    *    *    *    *    *    *    *    *    *    *    *    *    *    *    *    *    *    *    *    *    *    *    *    *    *    *    *    *    *    *    *    *    *    *    *    *    *    *    *    *    *    *    *    *  
  *    *    *    *    *    *    *    *    *    *    *    *    *    *    *    *    *    *    *    *    *    *    *    *    *    *    *    *    *    *    *    *    *    *    *    *    *    *    *    *    *    *    *    *    *    *    *    *    *    *    *    *    *    *    *    *    *    *    *    *    *    *    *    *    *    *    *    *    *    *    *  
  *    *    *    *    *    *    *    *    *    *    *    *    *    *    *    *    *    *    *    *    *    *    *    *    *    *    *    *    *    *    *    *    *    *    *    *    *    *    *    *    *    *    *    *    *    *    *    *    *    *    *    *    *    *    *    *    *    *    *    *    *    *    *    *    *    *    *    *    *    *    *  
  *    *    *    *    *    *    *    *    *    *    *    *    *    *    *    *    *    *    *    *    *    *    *    *    *    *    *    *    *    *    *    *    *    *    *    *    *    *    *    *    *    *    *    *    *    *    *    *    *    *    *    *    *    50   50   50   51   50   *    *    *    *    *    *    *    *    *    *    *    *    *  
  *    *    *    *    *    *    *    *    *    *    *    *    *    *    *    *    *    *    *    *    *    *    *    *    *    *    *    *    *    *    *    *    *    *    *    *    *    *    *    *    *    *    *    *    *    *    *    *    *    *    *    50   50   55   53   51   51   51   *    *    *    *    *    *    *    *    *    *    *    *    *  
  *    *    *    *    *    *    *    *    *    *    *    *    *    *    *    *    *    *    *    *    *    *    *    *    *    *    *    *    *    *    *    *    *    *    *    *    *    *    *    *    *    *    *    *    *    *    *    *    *    *    *    50   52   51   53   57   56   51   *    *    *    *    *    *    *    *    *    *    *    *    *  
  *    *    *    *    *    *    *    *    *    *    *    *    *    *    *    *    *    *    *    *    *    *    *    *    *    *    *    *    *    *    *    *    *    *    *    *    *    *    *    *    *    *    *    *    *    *    *    *    *    *    *    49   51   54   51   59   57   51   *    *    *    *    *    *    *    *    *    *    *    *    *  
  *    *    *    *    *    *    *    50   53   49   *    *    *    *    *    *    *    *    *    *    *    *    *    *    *    *    *    *    *    *    *    *    *    *    *    *    *    *    *    *    *    *    *    *    *    *    *    *    *    *    50   49   44   51   44   48   51   50   *    *    *    *    *    *    *    *    *    *    *    *    *  
  *    *    *    *    *    *    *    50   52   49   49   *    *    *    *    *    *    *    *    *    *    *    *    *    *    *    *    *    *    *    *    *    *    *    *    *    *    *    *    *    *    *    *    *    *    *    *    *    *    *    49   45   38   40   36   42   49   *    *    *    *    *    *    *    *    *    *    *    *    *    *  
  *    *    *    *    *    51   51   49   50   49   47   48   50   *    *    *    *    *    *    *    *    *    *    *    *    *    *    *    *    *    *    *    *    *    *    *    *    *    *    *    *    *    *    *    *    *    *    *    *    *    49   42   41   35   36   45   50   *    *    *    *    *    *    *    *    *    *    *    *    *    *  
  *    *    *    *    *    50   50   49   49   49   54   67   53   52   48   50   50   *    *    50   51   58   53   55   50   *    *    *    *    *    *    *    *    *    *    *    *    *    *    *    *    *    *    *    *    *    *    *    *    50   48   42   38   33   40   50   *    *    *    *    *    *    *    *    *    *    *    *    *    *    *  
  *    *    *    *    *    *    50   50   49   49   58   87   76   33   42   57   47   50   50   64   84   95   86   88   63   53   *    *    *    *    *    *    *    *    *    *    *    *    *    *    *    *    *    *    *    *    *    *    *    49   50   40   34   35   46   50   *    *    *    *    *    *    *    *    *    *    *    *    *    *    *  
  *    *    *    *    *    *    *    *    50   52   62   77   67   46   47   51   48   50   62   94   98   99   98   98   97   85   62   51   *    *    *    *    *    *    *    *    *    *    *    *    *    *    *    *    *    *    *    *    50   45   46   45   35   40   49   *    *    *    *    *    *    *    *    *    *    *    *    *    *    *    *  
  *    *    *    *    *    *    *    *    *    51   53   51   53   37   45   11   10   15   89   98   99   99   90   93   99   98   98   91   70   62   50   *    *    *    *    *    *    *    *    *    *    *    *    *    *    *    *    50   51   45   47   39   36   45   50   *    *    *    *    *    *    *    *    *    *    *    *    *    *    *    *  
  *    *    *    *    *    *    *    *    *    *    51   47   45   46   40   13   3    28   71   98   99   55   13   17   52   87   93   98   98   97   89   69   56   50   *    *    *    *    *    *    *    *    *    *    *    *    *    49   53   47   47   29   41   49   *    *    *    *    *    *    *    *    *    *    *    *    *    *    *    *    *  
  *    *    *    *    *    *    *    *    *    *    *    *    49   48   47   47   30   76   97   99   95   0    0    0    0    4    24   73   83   97   99   98   97   78   57   51   *    *    *    *    *    *    *    *    *    *    50   56   53   64   52   39   47   *    *    *    *    *    *    *    *    *    *    *    *    *    *    *    *    *    *  
  *    *    *    *    *    *    *    *    *    *    *    *    *    51   53   53   59   82   98   99   45   0    0    0    0    0    0    0    3    39   78   97   99   99   98   92   74   55   51   *    *    *    *    *    *    51   52   70   64   87   64   46   50   *    *    *    *    *    *    *    *    *    *    *    *    *    *    *    *    *    *  
  *    *    *    *    *    *    *    *    *    *    *    *    *    *    50   51   63   94   99   85   0    0    0    0    0    0    0    0    0    0    0    34   61   80   96   99   98   98   88   62   56   52   *    50   50   72   83   85   87   91   62   47   50   *    *    *    *    *    *    *    *    *    *    *    *    *    *    *    *    *    *  
  *    *    *    *    *    *    *    *    *    *    *    *    *    *    *    51   84   98   98   0    0    0    0    0    0    0    0    0    0    0    0    0    0    0    29   58   93   98   99   98   98   87   67   59   50   84   92   97   99   94   68   51   *    *    *    *    *    *    *    *    *    *    *    *    *    *    *    *    *    *    *  
  *    *    *    *    *    *    *    *    *    *    *    *    *    *    50   61   96   99   74   0    0    0    0    0    0    0    0    0    0    0    0    0    0    0    0    0    0    34   49   90   98   98   98   96   80   49   19   84   98   95   65   51   *    *    *    *    *    *    *    *    *    *    *    *    *    *    *    *    *    *    *  
  *    *    *    *    *    *    *    *    *    *    *    *    *    *    56   88   99   96   0    0    0    0    0    0    0    0    0    0    0    0    0    0    0    0    0    0    0    0    0    4    27   49   87   97   98   98   65   80   95   86   56   *    *    *    *    *    *    *    *    *    *    *    *    *    *    *    *    *    *    *    *  
  *    *    *    *    *    *    *    *    *    *    *    *    *    *    65   95   99   64   0    0    0    0    0    0    0    0    0    0    0    0    0    0    0    0    0    0    0    0    0    0    0    0    0    21   73   91   84   89   95   79   52   *    *    *    *    *    *    *    *    *    *    *    *    *    *    *    *    *    *    *    *  
  *    *    *    *    *    *    *    *    *    *    *    50   50   50   77   98   99   20   0    0    0    0    0    0    0    0    0    0    0    0    0    0    0    0    0    0    0    0    0    0   [s]  [s]  [s]   0    0    7    56   89   92   65   50   *    *    *    *    *    *    50   50   *    *    *    *    *    *    *    *    *    *    *    *  
  *    *    *    *    *    *    *    *    *    *    *    51   51   53   91   98   94   0    0    0    0    0    0    0    0    0    0    0    0    0    0    0    0    0    0    0    0    0    0   [s]  [s]  [s]  [s]  [s]   0    0    38   89   89   73   52   51   53   68   67   53   51   52   54   50   *    *    *    *    *    *    *    *    *    *    *  
  *    *    *    *    *    *    *    *    *    *    *    50   51   75   98   99   55   0    0    0    0    0    0    0    0    0    0    0    0    0    0    0    0    0    0    0    0    0    0   [s]  [s]  [m]  [s]  [s]   0    0    31   95   97   97   82   73   64   93   95   77   55   53   50   *    *    *    *    *    *    *    *    *    *    *    *  
  *    *    *    *    *    *    *    *    *    *    *    *    52   90   98   99   71   0    0    0    0    0    0    0    0    0    0    0    0    0    0    0    0    0    0    0    0    0    0   [s]  [s]  [s]  [s]  [s]   0    0    0    44   87   94   99   97   95   98   99   90   61   50   *    *    *    *    *    *    *    *    *    *    *    *    *  
  *    *    *    *    *    *    *    *    *    *    *    *    54   77   97   99   95   3    0    0    0    0    0    0    0    0    0    0    0    0    0    0    0    0    0    0    0    0    0    0   [s]  [s]  [s]   0    0    0    0    0    0    7    82   96   99   99   99   87   52   *    *    *    *    *    *    *    *    *    *    *    *    *    *  
  *    *    *    *    *    *    *    *    *    *    *    *    50   51   75   95   99   89   0    0    0    0    0    0    0    0    0    0    0    0    0    0    0    0    0    0    0    0    0    0    0    0    0    0    0    0    0    0    0    0    0    62   99   99   97   73   54   *    *    *    *    *    *    *    *    *    *    *    *    *    *  
  *    *    *    *    *    *    *    *    *    *    *    *    *    50   57   84   98   99   61   0    0    0    0    0    0    0    0    0    0    0    0    0    0    0    0    0    0    0    0    0    0    0    0    0    0    0    0    0    0    0    0    38   99   99   94   65   51   *    *    *    *    *    *    *    *    *    *    *    *    *    *  
  *    *    *    *    *    *    *    *    *    *    *    *    *    50   51   60   91   99   95   10   0    0    0    0    0    0    0    0    0    0    0    0    0    0    0    0    0    0    0    0    0    0    0    0    0    0    0    0    0    0    0    82   98   98   87   56   50   *    *    *    *    *    *    *    *    *    *    *    *    *    *  
  *    *    *    *    *    *    *    *    *    *    *    *    *    *    50   51   72   96   99   90   0    0    0    0    0    0    0    0    0    0    0    0    0    0    0    0    0    0    0    0    0    0    0    0    0    0    0    0    0    53   86   96   98   96   71   52   51   *    *    *    *    *    *    *    *    *    *    *    *    *    *  
  *    *    *    *    *    *    *    *    *    *    *    *    *    *    *    50   53   86   98   99   73   0    0    0    0    0    0    0    0    0    0    0    0    0    0    0    0    0    0    0    0    0    0    0    0    0    0    0    0    98   99   99   98   87   55   55   50   *    *    *    *    *    *    *    *    *    *    *    *    *    *  
  *    *    *    *    *    *    *    *    *    *    *    *    *    *    *    *    50   60   91   99   96   17   0    0    0    0    0    0    0    0    0    0    0    0    0    0    0    0    0    0    0    0    0    0    0    0    0    0    0    98   99   99   97   65   53   51   50   *    *    *    *    *    *    *    *    *    *    *    *    *    *  
  *    *    *    *    *    *    *    *    *    *    *    *    *    *    *    *    *    50   62   96   99   92   0    0    0    0    0    0    0    0    0    0    0    0    0    0    0    0    0    0    0    0    0    0    0    0    0    0    0    97   99   99   87   57   50   *    *    *    *    *    *    *    *    *    *    *    *    *    *    *    *  
  *    *    *    *    *    *    *    *    *    *    *    *    *    *    *    *    *    *    50   71   98   99   53   0    0    0    0    0    0    0    0    0    0    0    0    0    0    0    0    0    0    0    0    0    0    0    0    0    20   96   99   97   69   52   50   *    *    *    *    *    *    *    *    *    *    *    *    *    *    *    *  
  *    *    *    *    *    *    *    *    *    *    *    *    *    *    *    *    *    *    *    52   90   99   98   25   0    0    0    0    0    0    0    0    0    0    0    0    0    0    0    0    0    0    0    0    0    0    0    0    60   96   99   90   58   51   *    *    *    *    *    *    *    *    *    *    *    *    *    *    *    *    *  
  *    *    *    *    *    *    *    *    *    *    *    *    *    *    *    *    *    *    *    50   56   95   99   93   0    0    0    0    0    0    0    0    0    0   [r]   0    0    0    0    0    0    0    0    0    0    0    0    0    82   98   98   78   51   *    *    *    *    *    *    *    *    *    *    *    *    *    *    *    *    *    *  
  *    *    *    *    *    *    *    *    *    *    *    *    *    *    *    *    *    *    *    50   52   80   98   99   75   19   0    0    0    0    0    0    0    0    0    0    0    0    0    0    0    0    0    0    0    0    37   76   96   99   94   65   51   *    *    *    *    *    *    *    *    *    *    *    *    *    *    *    *    *    *  
  *    *    *    *    *    *    *    *    *    *    *    *    *    *    *    *    *    *    *    50   52   55   90   98   99   99   91   95   87   26   0    0    0    0    0    0    0    0    0    0    0    0    0    0    0    0    87   99   99   98   88   62   51   50   *    *    *    *    *    *    *    *    *    *    *    *    *    *    *    *    *  
  *    *    *    *    *    *    *    *    *    *    *    *    *    *    *    *    *    *    *    *    *    50   52   73   89   97   98   99   99   98   91   73   0    0    0    0    0    0    0    0    0    0    0    0    0    0    92   99   99   96   69   53   *    *    *    *    *    *    *    *    *    *    *    *    *    *    *    *    *    *    *  
  *    *    *    *    *    *    *    *    *    *    *    *    *    *    *    *    *    *    *    *    *    50   49   50   51   61   73   80   79   97   99   99   96   89   50   0    0    0    0    0    0    0    0    0    0    0    88   99   98   73   58   51   *    *    *    *    *    *    *    *    *    *    *    *    *    *    *    *    *    *    *  
  *    *    *    *    *    *    *    *    *    *    *    *    *    *    *    *    *    *    *    *    *    53   50   *    50   52   49   50   51   60   69   88   98   99   98   96   66   16   0    0    0    0    0    0    0    0    82   99   95   66   55   50   *    *    *    *    *    *    *    *    *    *    *    *    *    *    *    *    *    *    *  
  *    *    *    *    *    *    *    *    *    *    *    *    *    *    *    *    *    *    *    *    *    *    *    *    *    50   53   49   *    *    50   53   62   68   86   98   99   99   81   56   0    0    0    0    0    56   92   99   94   60   52   51   *    *    *    *    *    *    *    *    *    *    *    *    *    *    *    *    *    *    *  
  *    *    *    *    *    *    *    *    *    *    *    *    *    *    *    *    *    *    *    *    *    *    *    *    *    49   50   50   *    *    *    *    50   51   53   55   80   98   99   99   98   76   60   0    0    82   99   98   86   55   50   53   *    *    *    *    *    *    *    *    *    *    *    *    *    *    *    *    *    *    *  
  *    *    *    *    *    *    *    *    *    *    *    *    *    *    *    *    *    *    *    *    *    *    *    *    50   49   50   *    *    *    *    *    *    *    *    *    51   59   78   97   99   99   99   87   88   99   99   98   81   54   51   50   *    *    *    *    *    *    *    *    *    *    *    *    *    *    *    *    *    *    *  
  *    *    *    *    *    *    *    *    *    *    *    *    *    *    *    *    *    *    *    *    *    *    *    *    50   49   50   *    *    *    *    *    *    *    *    *    *    *    50   57   68   92   98   98   98   98   97   93   78   62   53   50   *    *    *    *    *    *    *    *    *    *    *    *    *    *    *    *    *    *    *  
  *    *    *    *    *    *    *    *    *    *    *    *    *    *    *    *    *    *    *    *    *    *    *    *    51   51   50   *    *    *    *    *    *    *    *    *    *    *    *    *    *    51   61   75   65   59   48   53   62   51   51   50   *    *    *    *    *    *    *    *    *    *    *    *    *    *    *    *    *    *    *  
  *    *    *    *    *    *    *    *    *    *    *    *    *    *    *    *    *    *    *    *    *    *    *    *    51   51   *    *    *    *    *    *    *    *    *    *    *    *    *    *    *    *    *    47   23   3    21   26   38   42   48   50   50   *    *    *    *    *    *    *    *    *    *    *    *    *    *    *    *    *    *  
  *    *    *    *    *    *    *    *    *    *    *    *    *    *    *    *    *    *    *    *    *    *    *    *    *    *    *    *    *    *    *    *    *    *    *    *    *    *    *    *    *    *    *    50   27   6    15   11   11   24   42   49   50   *    *    *    *    *    *    *    *    *    *    *    *    *    *    *    *    *    *  
  *    *    *    *    *    *    *    *    *    *    *    *    *    *    *    *    *    *    *    *    *    *    *    *    *    *    *    *    *    *    *    *    *    *    *    *    *    *    *    *    *    *    *    51   36   13   17   24   9    11   29   49   50   *    *    *    *    *    *    *    *    *    *    *    *    *    *    *    *    *    *  
  *    *    *    *    *    *    *    *    *    *    *    *    *    *    *    *    *    *    *    *    *    *    *    *    *    *    *    *    *    *    *    *    *    *    *    *    *    *    *    *    *    *    *    50   39   13   18   22   19   16   21   37   47   50   *    *    *    *    *    *    *    *    *    *    *    *    *    *    *    *    *  
  *    *    *    *    *    *    *    *    *    *    *    *    *    *    *    *    *    *    *    *    *    *    *    *    *    *    *    *    *    *    *    *    *    *    *    *    *    *    *    *    *    *    *    50   42   19   25   20   22   30   32   31   37   48   50   *    *    *    *    *    *    *    *    *    *    *    *    *    *    *    *  
  *    *    *    *    *    *    *    *    *    *    *    *    *    *    *    *    *    *    *    *    *    *    *    *    *    *    *    *    *    *    *    *    *    *    *    *    *    *    *    *    *    *    *    *    47   25   24   23   25   33   38   33   28   38   47   50   50   *    *    *    *    *    *    *    *    *    *    *    *    *    *  
  *    *    *    *    *    *    *    *    *    *    *    *    *    *    *    *    *    *    *    *    *    *    *    *    *    *    *    *    *    *    *    *    *    *    *    *    *    *    *    *    *    *    *    *    48   24   30   28   30   31   34   36   31   35   40   47   50   50   *    *    *    *    *    *    *    *    *    *    *    *    *  
  *    *    *    *    *    *    *    *    *    *    *    *    *    *    *    *    *    *    *    *    *    *    *    *    *    *    *    *    *    *    *    *    *    *    *    *    *    *    *    *    *    *    *    *    49   31   27   26   26   32   38   41   36   39   36   42   50   49   50   *    *    *    *    *    *    *    *    *    *    *    *  
  *    *    *    *    *    *    *    *    *    *    *    *    *    *    *    *    *    *    *    *    *    *    *    *    *    *    *    *    *    *    *    *    *    *    *    *    *    *    *    *    *    *    *    *    49   32   30   35   32   36   35   44   42   36   39   40   45   47   49   50   *    *    *    *    *    *    *    *    *    *    *  
  *    *    *    *    *    *    *    *    *    *    *    *    *    *    *    *    *    *    *    *    *    *    *    *    *    *    *    *    *    *    *    *    *    *    *    *    *    *    *    *    *    *    *    *    49   38   38   44   44   47   45   46   47   43   45   41   41   44   47   49   50   *    *    *    *    *    *    *    *    *    *  
  *    *    *    *    *    *    *    *    *    *    *    *    *    *    *    *    *    *    *    *    *    *    *    *    *    *    *    *    *    *    *    *    *    *    *    *    *    *    *    *    *    *    *    *    50   47   44   44   55   52   52   53   53   50   45   39   41   41   43   47   49   50   *    *    *    *    *    *    *    *    *  
  *    *    *    *    *    *    *    *    *    *    *    *    *    *    *    *    *    *    *    *    *    *    *    *    *    *    *    *    *    *    *    *    *    *    *    *    *    *    *    *    *    *    *    *    50   59   45   48   51   51   55   56   53   49   46   41   42   44   42   44   47   49   50   *    *    *    *    *    *    *    *  
  *    *    *    *    *    *    *    *    *    *    *    *    *    *    *    *    *    *    *    *    *    *    *    *    *    *    *    *    *    *    *    *    *    *    *    *    *    *    *    *    *    *    *    *    50   55   61   58   55   58   60   52   49   49   49   47   44   44   44   43   44   45   50   50   *    *    *    *    *    *    *  
  *    *    *    *    *    *    *    *    *    *    *    *    *    *    *    *    *    *    *    *    *    *    *    *    *    *    *    *    *    *    *    *    *    *    *    *    *    *    *    *    *    *    *    *    *    51   56   60   51   *    51   49   50   49   49   49   51   45   51   46   46   45   51   50   50   50   *    *    *    *    *  
  *    *    *    *    *    *    *    *    *    *    *    *    *    *    *    *    *    *    *    *    *    *    *    *    *    *    *    *    *    *    *    *    *    *    *    *    *    *    *    *    *    *    *    *    *    *    *    53   50   *    50   49   49   51   51   50   50   51   57   51   47   45   49   50   50   50   *    *    *    *    *  
  *    *    *    *    *    *    *    *    *    *    *    *    *    *    *    *    *    *    *    *    *    *    *    *    *    *    *    *    *    *    *    *    *    *    *    *    *    *    *    *    *    *    *    *    *    *    *    *    *    *    *    50   49   51   51   50   50   51   54   51   50   53   53   53   53   50   *    *    *    *    *  
  *    *    *    *    *    *    *    *    *    *    *    *    *    *    *    *    *    *    *    *    *    *    *    *    *    *    *    *    *    *    *    *    *    *    *    *    *    *    *    *    *    *    *    *    *    *    *    *    *    *    *    50   49   50   *    *    *    *    *    *    *    51   50   *    *    *    *    *    *    *    *  
  *    *    *    *    *    *    *    *    *    *    *    *    *    *    *    *    *    *    *    *    *    *    *    *    *    *    *    *    *    *    *    *    *    *    *    *    *    *    *    *    *    *    *    *    *    *    *    *    *    *    *    *    49   50   50   *    *    *    *    *    *    *    *    *    *    *    *    *    *    *    *  
  *    *    *    *    *    *    *    *    *    *    *    *    *    *    *    *    *    *    *    *    *    *    *    *    *    *    *    *    *    *    *    *    *    *    *    *    *    *    *    *    *    *    *    *    *    *    *    *    *    *    *    *    49   49   50   *    *    *    *    *    *    *    *    *    *    *    *    *    *    *    *  
  *    *    *    *    *    *    *    *    *    *    *    *    *    *    *    *    *    *    *    *    *    *    *    *    *    *    *    *    *    *    *    *    *    *    *    *    *    *    *    *    *    *    *    *    *    *    *    *    *    *    *    *    50   49   49   *    *    *    *    *    *    *    *    *    *    *    *    *    *    *    *  
  *    *    *    *    *    *    *    *    *    *    *    *    *    *    *    *    *    *    *    *    *    *    *    *    *    *    *    *    *    *    *    *    *    *    *    *    *    *    *    *    *    *    *    *    *    *    *    *    *    *    *    *    *    50   49   *    *    *    *    *    *    *    *    *    *    *    *    *    *    *    *  
  *    *    *    *    *    *    *    *    *    *    *    *    *    *    *    *    *    *    *    *    *    *    *    *    *    *    *    *    *    *    *    *    *    *    *    *    *    *    *    *    *    *    *    *    *    *    *    *    *    *    *    *    *    51   51   *    *    *    *    *    *    *    *    *    *    *    *    *    *    *    *  
  *    *    *    *    *    *    *    *    *    *    *    *    *    *    *    *    *    *    *    *    *    *    *    *    *    *    *    *    *    *    *    *    *    *    *    *    *    *    *    *    *    *    *    *    *    *    *    *    *    *    *    *    *    50   50   *    *    *    *    *    *    *    *    *    *    *    *    *    *    *    *  
  *    *    *    *    *    *    *    *    *    *    *    *    *    *    *    *    *    *    *    *    *    *    *    *    *    *    *    *    *    *    *    *    *    *    *    *    *    *    *    *    *    *    *    *    *    *    *    *    *    *    *    *    *    *    *    *    *    *    *    *    *    *    *    *    *    *    *    *    *    *    *  
  *    *    *    *    *    *    *    *    *    *    *    *    *    *    *    *    *    *    *    *    *    *    *    *    *    *    *    *    *    *    *    *    *    *    *    *    *    *    *    *    *    *    *    *    *    *    *    *    *    *    *    *    *    *    *    *    *    *    *    *    *    *    *    *    *    *    *    *    *    *    *  
  *    *    *    *    *    *    *    *    *    *    *    *    *    *    *    *    *    *    *    *    *    *    *    *    *    *    *    *    *    *    *    *    *    *    *    *    *    *    *    *    *    *    *    *    *    *    *    *    *    *    *    *    *    *    *    *    *    *    *    *    *    *    *    *    *    *    *    *    *    *    *  
  *    *    *    *    *    *    *    *    *    *    *    *    *    *    *    *    *    *    *    *    *    *    *    *    *    *    *    *    *    *    *    *    *    *    *    *    *    *    *    *    *    *    *    *    *    *    *    *    *    *    *    *    *    *    *    *    *    *    *    *    *    *    *    *    *    *    *    *    *    *    *  
  *    *    *    *    *    *    *    *    *    *    *    *    *    *    *    *    *    *    *    *    *    *    *    *    *    *    *    *    *    *    *    *    *    *    *    *    *    *    *    *    *    *    *    *    *    *    *    *    *    *    *    *    *    *    *    *    *    *    *    *    *    *    *    *    *    *    *    *    *    *    *  
  *    *    *    *    *    *    *    *    *    *    *    *    *    *    *    *    *    *    *    *    *    *    *    *    *    *    *    *    *    *    *    *    *    *    *    *    *    *    *    *    *    *    *    *    *    *    *    *    *    *    *    *    *    *    *    *    *    *    *    *    *    *    *    *    *    *    *    *    *    *    *  
