  *    *    *    *    *    *    *    *    *    *    *    *    *    *    *    *    *    *    *    *    *    *    *    *    *    *    *    *    *    *    *    *    *    *    *    *    *    *    *    *    *    *    *    *    *    *    *    *    *    *    *    *    *    *    *    *    *    *    *    *    *    *    *    *    *    *    *    *    *    *    *    *    *    *    *    *    *    *    *    *  
  *    *    *    *    *    *    *    *    *    *    *    *    *    *    *    *    *    *    *    *    *    *    *    *    *    *    *    *    *    *    *    *    *    *    *    *    *    *    *    *    *    *    *    *    *    *    *    *    *    *    *    *    *    *    *    *    *    *    *    *    *    *    *    *    *    *    *    *    *    *    *    *    *    *    *    *    *    *    *    *  
  *    *    *    *    *    *    *    *    *    *    *    *    *    *    *    *    *    *    *    *    *    *    *    *    *    *    *    *    *    *    *    *    *    *    *    *    *    *    *    *    *    *    *    *    *    *    *    *    *    *    *    *    *    *    *    *    *    *    *    *    *    *    *    *    *    *    *    *    *    *    *    *    *    *    *    *    *    *    *    *  
  *    *    *    *    *    *    *    *    *    *    *    *    *    *    *    *    *    *    *    *    *    *    *    *    *    *    *    *    *    *    *    *    *    *    *    *    *    *    *    *    *    *    *    *    *    *    *    *    *    *    *    *    *    *    *    *    *    *    *    *    *    *    *    *    *    *    *    *    *    *    *    *    *    *    *    *    *    *    *    *  
  *    *    *    *    *    *    *    *    *    *    *    *    *    *    *    *    *    *    *    *    *    *    *    *    *    *    *    *    *    *    *    *    *    *    *    *    *    *    *    *    *    *    *    *    *    *    *    *    *    *    *    *    *    *    *    *    *    *    *    *    *    *    *    *    *    *    *    *    *    *    *    *    *    *    *    *    *    *    *    *  
  *    *    *    *    *    *    *    *    *    *    *    *    *    *    *    *    *    *    *    *    *    *    *    *    *    50   50   *    *    *    *    *    *    *    *    *    *    *    *    *    *    *    *    *    *    *    *    *    *    *    *    *    *    *    *    *    *    *    *    *    *    *    *    *    *    *    *    *    *    *    *    *    *    *    *    *    *    *    *    *  
  *    *    *    *    *    *    *    *    *    *    *    *    *    *    *    *    *    *    *    50   50   *    *    *    *    51   51   50   *    *    *    *    *    *    *    *    *    *    *    *    *    *    *    *    *    *    *    *    *    *    *    *    *    *    *    *    *    *    *    *    *    *    *    *    *    *    *    *    *    *    *    *    *    *    *    *    *    *    *    *  
  *    *    *    *    *    *    *    *    *    *    *    *    *    *    *    *    *    50   50   51   53   50   *    50   50   51   50   51   50   *    *    *    *    *    *    *    *    *    *    *    *    *    *    *    *    *    *    *    *    *    *    *    *    *    *    *    *    *    *    *    *    *    *    *    *    *    *    *    *    *    *    *    *    *    *    *    *    *    *    *  
  *    *    *    *    *    *    *    *    *    *    *    *    *    *    *    *    *    51   52   49   49   49   50   54   53   49   52   55   50   *    *    *    *    *    *    *    *    *    *    *    *    *    *    *    *    *    *    *    *    *    *    *    *    *    *    *    *    *    *    *    *    *    *    *    *    *    *    *    *    *    *    *    *    *    *    *    *    *    *    *  
  *    *    *    *    *    *    *    *    *    *    *    *    *    *    *    50   50   50   49   49   49   49   52   51   48   50   52   45   50   50   *    *    *    *    *    *    *    *    *    *    *    *    *    *    *    *    *    *    *    *    *    *    *    *    *    *    *    *    *    *    *    *    *    *    *    *    *    *    *    *    *    *    *    *    *    *    *    *    *    *  
  *    *    *    *    *    *    *    *    *    *    *    *    *    *    *    53   50   50   50   49   52   53   47   46   51   52   48   43   47   49   *    *    *    *    *    *    *    *    *    *    *    *    *    *    *    *    *    *    *    *    *    *    *    *    *    *    *    *    *    *    *    *    *    *    *    *    *    *    *    *    *    *    *    *    *    *    *    *    *    *  
  *    *    *    *    *    *    *    *    *    *    *    *    *    *    *    *    49   49   49   51   55   53   47   46   50   44   47   44   43   47   50   *    *    *    *    *    *    *    *    *    *    *    *    *    *    *    *    *    *    *    *    *    *    *    *    *    *    *    *    *    *    *    *    *    *    *    *    *    *    *    *    *    *    *    *    *    *    *    *    *  
  *    *    *    *    *    50   50   50   *    *    *    *    *    *    *    *    *    *    51   51   49   47   52   47   45   43   41   44   43   44   49   *    *    *    *    *    *    *    *    *    *    *    *    *    *    *    *    *    *    *    *    *    *    *    *    *    *    *    *    *    *    *    *    *    *    *    *    *    *    *    *    *    *    *    *    *    *    *    *    *  
  *    *    *    *    *    52   49   49   50   50   50   *    *    *    *    *    *    *    52   50   45   45   46   45   42   44   41   40   43   43   47   50   *    *    *    *    *    *    *    *    *    *    *    *    *    *    *    *    *    *    *    *    *    *    *    *    *    *    *    *    *    *    *    *    *    *    *    *    *    *    *    *    *    *    *    *    *    *    *    *  
  *    *    *    *    *    *    *    49   49   49   49   50   50   50   *    *    *    *    *    50   48   45   42   38   39   43   44   40   40   42   43   49   *    *    *    *    *    *    *    *    *    *    *    *    *    *    *    *    *    *    *    *    *    *    *    *    *    *    *    *    *    *    *    *    *    *    *    *    *    *    *    *    *    *    *    *    *    *    *    *  
  *    *    *    *    *    *    *    *    *    *    49   49   49   49   50   50   50   *    *    52   50   48   48   40   36   42   52   42   39   44   51   49   *    50   50   *    *    *    *    *    *    *    *    *    *    *    *    *    *    *    *    *    *    *    *    *    *    *    *    *    *    *    *    *    *    *    *    *    *    *    *    *    *    *    *    *    *    *    *    *  
  *    *    *    *    *    *    *    *    *    *    *    *    *    49   49   49   49   50   50   49   49   49   47   44   38   36   40   39   38   38   40   47   50   51   51   50   *    50   50   *    *    *    *    *    *    *    *    *    *    *    50   *    50   50   *    *    *    *    *    *    *    *    *    *    *    *    *    *    *    *    *    *    *    *    *    *    *    *    *    *  
  *    *    *    *    *    *    *    *    *    *    *    *    *    *    *    *    49   49   50   49   50   49   50   50   44   36   40   38   40   36   37   36   46   49   55   51   50   53   51   50   50   50   50   *    *    *    *    *    *    *    52   50   51   51   50   50   50   51   *    *    *    *    *    *    *    *    *    *    *    *    *    *    *    *    *    *    *    *    *    *  
  *    *    *    *    *    *    *    *    *    *    *    *    *    *    *    *    *    *    52   48   49   50   51   47   49   44   36   44   42   42   34   39   44   53   55   58   54   51   50   51   52   56   51   50   50   50   50   *    *    50   53   55   54   56   56   50   51   52   51   *    *    *    *    *    *    *    *    *    *    *    *    *    *    *    *    *    *    *    *    *  
  *    *    *    *    *    *    *    *    *    *    *    *    *    *    *    *    *    *    *    49   49   49   48   49   48   55   36   31   42   45   45   58   72   82   83   83   79   79   68   59   51   51   57   59   59   55   53   52   52   57   76   84   78   85   84   65   53   54   55   *    50   50   50   50   *    *    *    *    *    *    *    *    *    *    *    *    *    *    *    *  
  *    *    *    *    *    *    *    *    *    *    *    *    *    *    *    *    *    *    *    *    *    *    49   49   49   50   44   42   44   57   75   87   89   91   91   91   91   91   91   91   91   91   91   91   91   91   91   91   91   91   91   92   91   92   91   91   84   67   56   50   49   49   50   53   *    *    *    *    *    *    *    *    *    *    *    *    *    *    *    *  
  *    *    *    *    *    *    *    *    *    *    *    *    *    *    *    *    *    *    *    *    *    *    *    *    *    49   49   53   63   73   88   91   91   89   88   84   87   87   82   79   76   80   78   76   76   76   76   76   76   76   76   73   68   65   74   90   93   87   60   55   52   49   49   *    *    *    *    *    *    *    *    *    *    *    *    *    *    *    *    *  
  *    *    *    *    *    *    *    *    *    *    *    *    *    *    *    *    *    *    *    *    *    *    *    *    *    *    *    48   61   75   88   92   88   27   12   0    0    0    0    0    0    0    0    0    0    0    0    0    0    0    0    0    0    0    0    42   81   93   91   79   59   53   50   *    *    *    *    *    *    *    *    *    *    *    *    *    *    *    *    *  
  *    *    *    *    *    *    *    *    *    *    *    *    *    *    *    *    *    *    *    *    *    *    *    *    *    *    *    51   62   60   81   93   89   32   0    0    0    0    0    0    0    0    0    0    0    0    0    0    0    0    0    0    0    0    0    0    13   79   92   92   78   60   53   52   *    *    *    *    *    *    *    *    *    *    *    *    *    *    *    *  
  *    *    *    *    *    *    *    *    *    *    *    *    *    *    *    *    *    *    *    *    *    *    50   50   50   *    50   54   61   71   85   91   91   36   0    0    0    0    0    0    0    0    0    0    0    0    0    0    0    0    0    0    0   [s]  [s]  [s]   0    0    50   82   93   89   68   56   *    *    *    *    *    *    *    *    *    *    *    *    *    *    *    *  
  *    *    *    *    *    *    *    *    *    *    *    *    *    *    *    *    *    *    *    *    *    *    52   49   49   50   51   51   59   79   86   91   91   32   0    0    0    0    0    0    0    0    0    0    0    0    0    0    0    0    0    0   [s]  [s]  [s]  [s]  [s]   0    0    25   81   93   91   76   55   50   *    *    *    *    *    *    *    *    *    *    *    *    *    *  
  *    *    *    *    *    *    *    *    *    *    *    *    *    *    *    *    *    *    *    *    *    *    *    *    49   50   49   51   51   77   85   91   93   31   0    0    0    0    0    0   [m]   0    0    0    0    0    0    0    0    0    0    0   [s]  [s]  [s]  [s]  [s]   0    0    0    0    79   93   93   86   64   53   50   *    *    *    *    *    *    *    *    *    *    *    *  
  *    *    *    *    *    *    *    *    *    *    *    *    *    *    *    *    *    *    *    *    *    *    *    50   50   53   49   47   51   77   85   93   93   66   0    0    0    0    0    0    0    0    0    0    0    0    0    0    0    0    0    0   [s]  [s]  [r]  [s]  [s]   0    0    0    0    0    70   91   93   91   83   58   51   *    *    *    *    *    *    *    *    *    *    *  
  *    *    *    *    *    *    *    *    *    *    *    *    *    *    *    *    *    *    *    *    *    *    *    52   49   49   49   51   55   81   89   93   93   67   0    0    0    0    0    0    0    0    0    0    0    0    0    0    0    0    0    0    0   [s]  [s]  [s]   0    0    0    0    0    0    0    29   90   93   92   88   62   51   *    *    *    *    *    *    *    *    *    *  
  *    *    *    *    *    *    *    *    *    *    *    *    *    *    *    *    *    *    *    *    *    *    *    *    *    *    50   50   51   82   89   93   88   28   0    0    0    0    0    0    0    0    0    0    0    0    0    0    0    0    0    0    0    0    0    0    0    0    0    0    0    0    0    0    8    85   94   91   63   52   *    *    *    *    *    *    *    *    *    *  
  *    *    *    *    *    *    *    *    *    *    *    *    *    *    *    *    *    *    *    *    *    *    *    *    *    *    52   50   53   81   89   94   86   23   0    0    0    0    0    0    0    0    0    0    0    0    0    0    0    0    0    0    0    0    0    0    0    0    0    0    0    0    0    0    0    20   93   91   70   53   *    *    *    *    *    *    *    *    *    *  
  *    *    *    *    *    *    *    *    *    *    *    *    *    *    *    *    *    *    *    *    *    *    *    *    *    *    *    49   51   69   88   93   90   29   0    0    0    0    0    0    0    0    0    0    0    0    0    0    0    0    0    0    0    0    0    0    0    0    0    0    0    0    0    0    0    10   93   89   62   52   *    *    *    *    *    *    *    *    *    *  
  *    *    *    *    *    *    *    *    *    *    *    *    *    *    *    *    *    *    *    *    *    *    *    *    *    *    *    *    51   78   89   93   88   27   0    0    0    0    0    0    0    0    0    0    0    0    0    0    0    0    0    0    0    0    0    0    0    0    0    0    0    0    0    0    0    24   93   90   62   51   *    *    *    *    *    *    *    *    *    *  
  *    *    *    *    *    *    *    *    *    *    *    *    *    *    *    *    *    *    *    *    *    *    *    *    *    *    *    50   55   80   92   93   82   22   0    0    0    0    0    0    0    0    0    0    0    0    0    0    0    0    0    0    0    0    0    0    0    0    0    0    0    0    0    0    0    15   93   90   61   54   *    *    *    *    *    *    *    *    *    *  
  *    *    *    *    *    *    *    *    *    *    *    *    *    *    *    *    *    *    *    *    *    *    *    *    *    *    *    51   58   85   92   93   89   36   0    0    0    0    0    0    0    0    0    0    0    0    0    0    0    0    0    0    0    0    0    0    0    0    0    0    0    0    0    0    0    26   93   90   57   52   *    *    *    *    *    *    *    *    *    *  
  *    *    *    *    *    *    *    *    *    *    *    *    *    *    *    *    *    *    *    *    *    *    *    *    *    *    *    *    52   82   91   92   90   18   0    0    0    0    0    0    0    0    0    0    0    0    0    0    0    0    0    0    0    0    0    0    0    0    0    0    0    0    0    0    0    42   94   89   58   50   *    *    *    *    *    *    *    *    *    *  
  *    *    *    *    *    *    *    *    *    *    *    *    *    *    *    *    *    *    *    *    *    *    *    *    *    *    *    *    56   84   90   90   78   0    0    0    0    0    0    0    0    0    0    0    0    0    0    0    0    0    0    0    0    0    0    0    0    0    0    0    0    0    0    0    0    66   94   89   57   53   50   *    *    *    *    *    *    *    *    *  
  *    *    *    *    *    *    *    *    *    *    *    *    *    *    *    *    *    *    *    *    *    *    *    *    *    *    *    50   57   83   89   89   44   0    0    0    0    0    0    0    0    0    0    0    0    0    0    0    0    0    0    0    0    0    0    0    0    0    0    0    0    0    0    0    0    76   93   88   52   50   53   *    *    *    *    *    *    *    *    *  
  *    *    *    *    *    *    *    *    *    *    *    *    *    *    *    *    *    *    *    *    *    *    *    *    *    *    *    53   60   84   89   90   23   0    0    0    0    0    0    0    0    0    0    0    0    0    0    0    0    0    0    0    0    0    0    0    0    0    0    0    0    0    0    4    38   90   93   87   52   49   53   51   *    *    *    *    *    *    *    *  
  *    *    *    *    *    *    *    *    *    *    *    *    *    *    *    *    *    *    *    *    *    *    *    *    *    50   50   54   60   84   89   82   22   5    0    0    0    0    0    0    0    0    0    0    0    0    0    0    0    0    0    0    0    0    0    0    0    9    15   49   65   67   91   92   93   93   93   89   62   53   53   51   49   50   50   *    *    *    *    *  
  *    *    *    *    *    *    *    *    *    *    *    *    *    *    *    *    *    *    *    *    *    *    *    *    50   49   49   53   76   86   87   90   91   92   91   88   86   76   7    0    0    0    0    0    0    0    0    0    0    0    0    0    4    42   68   76   85   92   93   94   93   93   91   91   91   91   88   79   62   54   55   62   55   53   55   *    *    *    *    *  
  *    *    *    *    *    *    *    *    *    *    *    *    *    *    *    *    *    *    *    *    *    *    *    *    52   49   51   56   70   86   87   88   89   89   90   90   91   92   65   0    0    0    0    0    0    0    0    9    33   55   78   88   91   93   94   93   90   90   89   88   85   84   72   64   76   77   65   55   51   *    48   48   53   52   *    *    *    *    *    *  
  *    *    *    *    *    *    *    *    *    *    *    *    *    *    *    *    *    *    *    *    *    *    *    *    50   49   49   51   60   84   88   82   73   72   70   71   84   87   74   8    14   31   56   81   80   84   90   93   93   93   92   90   89   87   86   80   56   55   *    50   50   55   55   *    53   62   *    *    *    *    *    *    *    *    *    *    *    *    *    *  
  *    *    *    *    *    *    *    *    *    *    *    *    *    *    *    *    *    *    *    *    *    *    *    *    52   49   51   56   58   67   78   76   56   51   55   52   84   88   92   89   93   93   92   91   90   90   89   85   82   75   66   51   49   50   52   53   49   50   *    52   *    *    *    *    *    *    *    *    *    *    *    *    *    *    *    *    *    *    *    *  
  *    *    *    *    *    *    *    *    *    *    *    *    *    *    *    *    *    *    *    *    *    *    *    *    *    *    *    51   53   50   49   52   49   51   *    55   82   89   84   62   79   80   77   66   63   55   53   50   53   49   *    49   51   53   *    *    49   49   *    *    *    *    *    *    *    *    *    *    *    *    *    *    *    *    *    *    *    *    *    *  
  *    *    *    *    *    *    *    *    *    *    *    *    *    *    *    *    *    *    *    *    *    *    *    *    *    *    *    *    *    52   *    *    *    *    *    51   73   84   73   27   58   51   *    *    *    *    *    *    *    *    *    *    *    *    *    *    49   50   51   *    *    *    *    *    *    *    *    *    *    *    *    *    *    *    *    *    *    *    *    *  
  *    *    *    *    *    *    *    *    *    *    *    *    *    *    *    *    *    *    *    *    *    *    *    *    *    *    *    *    *    *    *    *    *    *    *    55   73   87   87   82   68   *    *    *    *    *    *    *    *    *    *    *    *    *    *    *    *    49   52   *    *    *    *    *    *    *    *    *    *    *    *    *    *    *    *    *    *    *    *    *  
  *    *    *    *    *    *    *    *    *    *    *    *    *    *    *    *    *    *    *    *    *    *    *    *    *    *    *    *    *    *    *    *    *    *    *    52   70   86   84   76   *    *    *    *    *    *    *    *    *    *    *    *    *    *    *    *    *    *    *    *    *    *    *    *    *    *    *    *    *    *    *    *    *    *    *    *    *    *    *    *  
  *    *    *    *    *    *    *    *    *    *    *    *    *    *    *    *    *    *    *    *    *    *    *    *    *    *    *    *    *    *    *    *    *    *    *    51   58   61   56   52   *    *    *    *    *    *    *    *    *    *    *    *    *    *    *    *    *    *    *    *    *    *    *    *    *    *    *    *    *    *    *    *    *    *    *    *    *    *    *    *  
  *    *    *    *    *    *    *    *    *    *    *    *    *    *    *    *    *    *    *    *    *    *    *    *    *    *    *    *    *    *    *    *    *    *    *    49   57   59   50   *    *    *    *    *    *    *    *    *    *    *    *    *    *    *    *    *    *    *    *    *    *    *    *    *    *    *    *    *    *    *    *    *    *    *    *    *    *    *    *    *  
  *    *    *    *    *    *    *    *    *    *    *    *    *    *    *    *    *    *    *    *    *    *    *    *    *    *    *    *    *    *    *    *    *    *    *    49   49   60   52   *    *    *    *    *    *    *    *    *    *    *    *    *    *    *    *    *    *    *    *    *    *    *    *    *    *    *    *    *    *    *    *    *    *    *    *    *    *    *    *    *  
  *    *    *    *    *    *    *    *    *    *    *    *    *    *    *    *    *    *    *    *    *    *    *    *    *    *    *    *    *    *    *    *    *    *    *    51   48   48   49   *    *    *    *    *    *    *    *    *    *    *    *    *    *    *    *    *    *    *    *    *    *    *    *    *    *    *    *    *    *    *    *    *    *    *    *    *    *    *    *    *  
  *    *    *    *    *    *    *    *    *    *    *    *    *    *    *    *    *    *    *    *    *    *    *    *    *    *    *    *    *    *    *    *    *    *    *    49   49   48   49   *    *    *    *    *    *    *    *    *    *    *    *    *    *    *    *    *    *    *    *    *    *    *    *    *    *    *    *    *    *    *    *    *    *    *    *    *    *    *    *    *  
  *    *    *    *    *    *    *    *    *    *    *    *    *    *    *    *    *    *    *    *    *    *    *    *    *    *    *    *    *    *    *    *    *    *    50   48   46   48   49   *    *    *    *    *    *    *    *    *    *    *    *    *    *    *    *    *    *    *    *    *    *    *    *    *    *    *    *    *    *    *    *    *    *    *    *    *    *    *    *    *  
  *    *    *    *    *    *    *    *    *    *    *    *    *    *    *    *    *    *    *    *    *    *    *    *    *    *    *    *    *    *    *    *    *    *    49   48   47   48   49   *    *    *    *    *    *    *    *    *    *    *    *    *    *    *    *    *    *    *    *    *    *    *    *    *    *    *    *    *    *    *    *    *    *    *    *    *    *    *    *    *  
  *    *    *    *    *    *    *    *    *    *    *    *    *    *    *    *    *    *    *    *    *    *    *    *    *    *    *    *    *    *    *    *    *    *    49   48   47   47   49   *    *    *    *    *    *    *    *    *    *    *    *    *    *    *    *    *    *    *    *    *    *    *    *    *    *    *    *    *    *    *    *    *    *    *    *    *    *    *    *    *  
  *    *    *    *    *    *    *    *    *    *    *    *    *    *    *    *    *    *    *    *    *    *    *    *    *    *    *    *    *    *    *    *    *    *    49   48   47   47   50   *    *    *    *    *    *    *    *    *    *    *    *    *    *    *    *    *    *    *    *    *    *    *    *    *    *    *    *    *    *    *    *    *    *    *    *    *    *    *    *    *  
  *    *    *    *    *    *    *    *    *    *    *    *    *    *    *    *    *    *    *    *    *    *    *    *    *    *    *    *    *    *    *    *    *    *    49   47   49   49   50   *    *    *    *    *    *    *    *    *    *    *    *    *    *    *    *    *    *    *    *    *    *    *    *    *    *    *    *    *    *    *    *    *    *    *    *    *    *    *    *    *  
  *    *    *    *    *    *    *    *    *    *    *    *    *    *    *    *    *    *    *    *    *    *    *    *    *    *    *    *    *    *    *    *    *    *    49   52   54   49   50   *    *    *    *    *    *    *    *    *    *    *    *    *    *    *    *    *    *    *    *    *    *    *    *    *    *    *    *    *    *    *    *    *    *    *    *    *    *    *    *    *  
  *    *    *    *    *    *    *    *    *    *    *    *    *    *    *    *    *    *    *    *    *    *    *    *    *    *    *    *    *    *    *    *    *    *    49   49   49   49   *    *    *    *    *    *    *    *    *    *    *    *    *    *    *    *    *    *    *    *    *    *    *    *    *    *    *    *    *    *    *    *    *    *    *    *    *    *    *    *    *    *  
  *    *    *    *    *    *    *    *    *    *    *    *    *    *    *    *    *    *    *    *    *    *    *    *    *    *    *    *    *    *    *    *    *    *    51   54   52   50   *    *    *    *    *    *    *    *    *    *    *    *    *    *    *    *    *    *    *    *    *    *    *    *    *    *    *    *    *    *    *    *    *    *    *    *    *    *    *    *    *    *  
  *    *    *    *    *    *    *    *    *    *    *    *    *    *    *    *    *    *    *    *    *    *    *    *    *    *    *    *    *    *    *    *    *    *    *    *    51   53   *    *    *    *    *    *    *    *    *    *    *    *    *    *    *    *    *    *    *    *    *    *    *    *    *    *    *    *    *    *    *    *    *    *    *    *    *    *    *    *    *    *  
  *    *    *    *    *    *    *    *    *    *    *    *    *    *    *    *    *    *    *    *    *    *    *    *    *    *    *    *    *    *    *    *    *    *    *    *    *    *    *    *    *    *    *    *    *    *    *    *    *    *    *    *    *    *    *    *    *    *    *    *    *    *    *    *    *    *    *    *    *    *    *    *    *    *    *    *    *    *    *    *  
  *    *    *    *    *    *    *    *    *    *    *    *    *    *    *    *    *    *    *    *    *    *    *    *    *    *    *    *    *    *    *    *    *    *    *    *    *    *    *    *    *    *    *    *    *    *    *    *    *    *    *    *    *    *    *    *    *    *    *    *    *    *    *    *    *    *    *    *    *    *    *    *    *    *    *    *    *    *    *    *  
  *    *    *    *    *    *    *    *    *    *    *    *    *    *    *    *    *    *    *    *    *    *    *    *    *    *    *    *    *    *    *    *    *    *    *    *    *    *    *    *    *    *    *    *    *    *    *    *    *    *    *    *    *    *    *    *    *    *    *    *    *    *    *    *    *    *    *    *    *    *    *    *    *    *    *    *    *    *    *    *  
  *    *    *    *    *    *    *    *    *    *    *    *    *    *    *    *    *    *    *    *    *    *    *    *    *    *    *    *    *    *    *    *    *    *    *    *    *    *    *    *    *    *    *    *    *    *    *    *    *    *    *    *    *    *    *    *    *    *    *    *    *    *    *    *    *    *    *    *    *    *    *    *    *    *    *    *    *    *    *    *  
  *    *    *    *    *    *    *    *    *    *    *    *    *    *    *    *    *    *    *    *    *    *    *    *    *    *    *    *    *    *    *    *    *    *    *    *    *    *    *    *    *    *    *    *    *    *    *    *    *    *    *    *    *    *    *    *    *    *    *    *    *    *    *    *    *    *    *    *    *    *    *    *    *    *    *    *    *    *    *    *  
