  *    *    *    *    *    *    *    *    *    *    *    *    *    *    *    *    *    *    *    *    *    *    *    *    *    *    *    *    *    *    *    *    *    *    *    *    *    *    *    *    *    *    *    *    *    *    *    *    *    *    *    *    *    *    *    *    *    *    *  
  *    *    *    *    *    *    *    *    *    *    *    *    *    *    *    *    *    *    *    *    *    *    *    *    *    *    *    *    *    *    *    *    *    *    *    *    *    *    *    *    *    *    *    *    *    *    *    *    *    *    *    *    *    *    *    *    *    *    *  
  *    *    *    *    *    *    *    *    *    *    *    *    *    *    *    *    *    *    *    *    *    *    *    *    *    *    *    *    *    *    *    *    *    *    *    *    *    *    *    *    *    *    *    *    *    *    *    *    *    *    *    *    *    *    *    *    *    *    *  
  *    *    *    *    *    *    *    *    *    *    *    *    *    *    *    *    *    *    *    *    *    *    *    *    *    *    *    *    *    *    *    *    *    *    *    *    *    *    *    *    *    *    *    *    *    *    *    *    *    *    *    *    *    *    *    *    *    *    *  
  *    *    *    *    *    *    *    *    *    *    *    *    *    *    *    *    *    *    *    *    *    *    *    *    *    *    *    *    *    *    *    *    *    *    *    *    *    *    *    *    *    *    *    *    *    *    *    *    *    *    *    *    *    *    *    *    *    *    *  
  *    *    *    *    *    *    *    *    *    *    *    *    *    *    *    *    *    *    *    *    *    *    *    *    *    *    *    *    *    *    *    *    *    *    *    *    50   50   *    *    *    *    *    *    *    *    *    *    *    *    *    *    *    *    *    *    *    *    *  
  *    *    *    *    *    *    *    *    *    *    *    *    *    *    *    *    *    *    *    *    *    *    *    *    *    *    *    *    *    *    *    *    *    *    *    *    51   51   *    *    *    *    *    *    *    *    *    *    *    *    *    *    *    *    *    *    *    *    *  
  *    *    *    *    *    *    *    *    *    *    *    *    *    *    *    *    *    *    *    *    *    *    *    *    *    *    *    *    *    *    *    *    *    *    *    *    50   50   *    *    *    *    *    *    *    *    *    *    *    *    *    *    *    *    *    *    *    *    *  
  *    *    *    *    *    *    *    *    *    *    *    *    *    *    *    *    *    *    *    *    *    *    *    *    *    *    *    *    *    *    *    *    *    *    *    *    49   49   *    51   51   51   *    *    *    *    *    *    *    *    *    *    *    *    *    *    *    *    *  
  *    *    *    *    *    *    *    *    *    *    *    *    *    *    *    *    *    *    *    *    *    *    *    *    *    *    *    *    *    *    *    *    *    *    *    *    49   49   50   52   53   53   50   *    *    *    *    *    *    *    *    *    *    *    *    *    *    *    *  
  *    *    *    *    *    *    *    *    *    *    *    *    *    *    *    *    *    *    *    *    *    *    *    *    *    *    *    *    *    *    *    *    *    *    *    *    49   49   50   49   48   49   50   *    *    *    *    *    *    *    *    *    *    *    *    *    *    *    *  
  *    *    *    *    *    *    *    *    *    *    *    *    *    *    *    *    *    *    *    *    *    *    *    *    *    *    *    *    *    *    *    *    *    *    *    *    49   49   49   49   48   48   50   *    *    *    *    *    *    *    *    *    *    *    *    *    *    *    *  
  *    *    *    *    *    *    *    *    *    *    *    *    *    *    *    *    *    *    *    *    *    *    *    *    *    *    *    *    *    *    *    *    *    *    *    *    49   49   49   49   49   48   50   *    *    *    *    *    *    *    *    *    *    *    *    *    *    *    *  
  *    *    *    *    *    *    *    *    *    *    *    *    *    *    *    *    *    *    *    *    *    *    *    *    *    *    *    *    *    *    *    *    *    *    *    *    49   49   49   50   49   48   50   50   51   50   *    *    *    *    *    *    *    *    *    *    *    *    *  
  *    *    *    *    *    *    *    *    *    *    *    *    *    *    *    *    *    *    *    *    *    *    *    *    *    *    *    *    *    *    *    *    *    *    *    *    49   49   49   50   49   48   50   50   53   50   *    *    *    *    *    *    *    *    *    *    *    *    *  
  *    *    *    *    *    *    *    *    *    *    *    *    *    *    *    *    *    *    *    *    *    *    *    *    *    *    *    *    *    *    *    *    *    *    *    *    49   49   49   50   49   48   52   50   49   50   *    *    *    *    *    *    *    *    *    *    *    *    *  
  *    *    *    *    *    *    *    *    *    *    *    *    *    *    *    *    *    *    *    *    *    *    *    *    *    *    *    *    *    *    *    *    *    *    *    *    50   49   48   50   51   49   52   50   50   50   *    50   51   50   *    *    *    *    *    *    *    *    *  
  *    *    *    *    *    *    *    *    *    *    *    *    *    *    *    *    *    *    *    *    *    *    *    *    *    *    *    *    *    *    *    *    *    *    *    *    *    49   48   49   50   51   55   50   53   50   51   49   52   50   *    *    *    *    *    *    *    *    *  
  *    *    *    *    *    *    *    *    *    *    *    *    *    *    *    *    *    *    *    *    *    *    *    *    *    *    *    *    *    *    *    *    *    *    *    *    *    49   48   47   45   44   53   49   51   52   52   51   50   *    *    *    *    *    *    *    *    *    *  
  *    *    *    *    *    *    *    *    *    *    *    *    *    *    *    *    *    *    *    *    *    *    *    *    *    *    *    *    *    *    *    *    *    *    *    *    *    49   48   49   45   42   53   55   52   52   52   52   50   *    *    *    *    *    *    *    *    *    *  
  *    *    *    *    *    *    *    *    *    *    *    *    *    *    *    *    *    *    *    *    *    *    *    *    *    *    *    *    *    *    *    *    *    *    *    *    *    49   48   45   47   42   41   51   48   50   51   51   50   *    *    *    *    *    *    *    *    *    *  
  *    *    *    *    *    *    *    *    *    *    *    *    *    *    *    *    *    *    *    *    *    *    *    *    *    *    *    *    *    *    *    *    *    *    *    *    50   50   47   42   46   44   38   42   45   46   47   51   *    *    *    *    *    *    *    *    *    *    *  
  *    *    *    *    *    *    *    *    *    *    *    *    *    *    *    *    *    *    *    *    *    *    *    *    *    *    *    *    *    *    *    *    *    *    *    *    51   50   45   42   41   41   40   43   42   40   45   49   *    *    *    *    *    *    *    *    *    *    *  
  *    *    *    *    *    *    *    *    *    *    *    *    *    *    *    *    *    *    *    *    *    *    *    *    *    *    *    *    *    *    *    *    *    *    *    *    49   49   44   40   37   37   42   44   40   44   49   *    *    *    *    *    *    *    *    *    *    *    *  
  *    *    *    *    *    *    *    *    *    *    *    *    *    *    *    *    *    *    *    *    *    *    *    *    *    *    *    *    *    *    *    *    *    *    *    *    49   49   44   37   35   34   40   39   40   47   49   *    *    *    *    *    *    *    *    *    *    *    *  
  *    *    *    *    *    *    *    *    *    *    *    *    *    *    *    *    *    *    *    *    *    *    *    *    *    *    *    *    *    *    *    *    *    *    *    50   50   49   41   35   35   34   39   38   45   49   *    *    *    *    *    *    *    *    *    *    *    *    *  
  *    *    *    *    *    *    *    *    *    *    *    *    *    *    *    *    *    *    *    *    *    *    *    *    *    *    *    *    *    *    *    *    *    *    *    51   50   47   36   33   33   38   40   41   47   49   *    *    *    *    *    *    *    *    *    *    *    *    *  
  *    *    *    *    *    *    *    *    *    *    *    *    *    *    *    *    *    *    *    *    *    *    *    *    *    *    *    *    *    *    *    *    *    *    *    53   50   43   36   34   32   40   43   47   49   *    *    *    *    *    *    *    *    *    *    *    *    *    *  
  *    *    *    *    *    *    *    *    *    *    *    *    *    *    *    *    *    *    *    *    *    *    *    *    *    *    *    *    *    *    *    *    *    *    *    51   52   42   40   37   33   33   38   48   50   *    *    *    *    *    *    *    *    *    *    *    *    *    *  
  *    *    *    *    *    *    *    *    *    *    *    *    *    *    *    *    *    *    *    *    *    *    *    *    *    *    *    *    *    50   50   *    50   50   51   51   59   55   42   31   34   37   45   49   *    *    *    *    *    *    *    *    *    *    *    *    *    *    *  
  *    *    *    *    *    *    *    *    *    *    *    *    *    *    *    *    *    *    *    *    *    *    *    *    *    50   50   *    *    52   51   50   52   53   59   61   70   82   70   48   33   41   49   *    *    *    *    *    *    *    *    *    *    *    *    *    *    *    *  
  *    *    *    *    *    *    *    *    *    *    *    *    *    *    *    *    *    *    *    *    *    *    *    *    *    52   50   *    *    49   52   53   53   61   76   82   84   88   90   80   54   49   49   *    *    *    *    *    *    *    *    *    *    *    *    *    *    *    *  
  *    *    *    *    *    *    *    *    *    *    *    *    *    *    *    *    *    *    *    *    *    *    *    *    *    50   50   50   50   50   51   55   60   74   85   88   88   93   93   93   89   60   50   *    *    *    *    *    *    *    *    *    *    *    *    *    *    *    *  
  *    *    *    *    *    *    *    *    *    *    *    *    *    *    *    *    *    *    *    *    *    *    *    *    *    50   51   53   54   57   62   75   81   87   88   92   88   82   78   89   93   75   54   *    *    *    *    *    *    *    *    *    *    *    *    *    *    *    *  
  *    *    *    *    *    *    *    *    *    *    *    *    *    *    *    *    *    *    *    *    *    *    *    *    *    50   50   55   61   76   85   88   88   93   90   84   30   0    3    67   91   91   64   50   *    *    *    *    *    *    *    *    *    *    *    *    *    *    *  
  *    *    *    *    *    *    *    *    *    *    *    *    *    *    *    *    *    *    *    *    50   50   50   50   52   52   55   66   82   87   88   93   93   93   62   0    0    0    0    8    79   93   74   53   *    *    *    *    *    *    *    *    *    *    *    *    *    *    *  
  *    *    *    *    *    *    *    *    *    *    *    *    *    *    *    *    *    *    50   50   51   51   51   57   62   67   76   87   89   93   91   88   83   80   52   0    0    0    0    0    49   89   90   63   50   *    *    *    *    *    *    *    *    *    *    *    *    *    *  
  *    *    *    *    *    *    *    *    *    *    *    *    *    *    *    *    *    50   53   51   51   58   62   72   76   86   90   93   91   85   31   0    0    0    0    0    0    0    0    0    2    77   93   73   53   50   *    *    *    *    *    *    *    *    *    *    *    *    *  
  *    *    *    *    *    *    *    *    *    *    *    *    *    *    51   50   50   52   58   64   64   81   86   87   90   93   94   87   35   0    0    0    0    0    0    0    0    0    0    0    0    34   86   85   61   50   *    *    *    *    *    *    *    *    *    *    *    *    *  
  *    *    *    *    *    *    *    *    *    *    *    *    *    *    52   51   50   54   71   86   87   89   86   83   85   91   89   41   0    0    0    0    0    0    0    0    0    0    0    0    0    0    68   92   68   50   *    *    *    *    *    *    *    *    *    *    *    *    *  
  *    *    *    *    *    *    *    *    *    *    *    *    *    *    50   49   51   58   82   90   92   91   80   51   49   68   25   0    0    0    0    0    0    0    0    0    0    0    0    0    0    0    36   87   80   57   *    *    *    *    *    *    *    *    *    *    *    *    *  
  *    *    *    *    *    *    *    *    *    *    *    *    *    *    *    *    *    52   77   89   91   91   57   0    0    0    0    0    0    0    0    0    0    0    0    0    0    0    0    0    0    0    0    75   92   70   50   *    *    *    *    *    *    *    *    *    *    *    *  
  *    *    *    *    *    *    *    *    *    *    *    *    *    *    *    *    *    *    62   62   76   89   87   10   0    0    0    0    0    0    0    0    0    0    0    0    0    0    0    0    0    0    0    36   86   82   58   *    *    *    *    *    *    *    *    *    *    *    *  
  *    *    *    *    *    *    *    *    *    *    *    *    *    *    *    *    *    *    *    50   61   83   91   52   11   0    0    0    0    0    0    0    0    0    0    0   [s]  [s]  [s]   0    0    0    0    0    73   93   72   51   *    *    *    *    *    *    *    *    *    *    *  
  *    *    *    *    *    *    *    *    *    *    *    *    *    *    *    *    *    *    *    *    51   72   90   84   9    0    0    0    0    0    0    0    0    0    0   [s]  [s]  [s]  [s]  [s]   0    0    0    0    47   89   87   61   50   *    *    *    *    *    *    *    *    *    *  
  *    *    *    *    *    *    *    *    *    *    *    *    *    *    *    *    *    *    *    *    50   70   87   91   13   0    0    0    0    0    0    0    0    0    0   [s]  [s]  [s]  [s]  [r]   0   [m]   0    0    0    76   93   75   53   *    *    *    *    *    *    *    *    *    *  
  *    *    *    *    *    *    *    *    *    *    *    *    *    *    *    *    *    *    *    51   58   80   85   90   50   6    0    0    0    0    0    0    0    0    0   [s]  [s]  [s]  [s]  [s]   0    0    0    0    0    47   90   89   65   50   50   50   *    *    *    *    *    *    *  
  *    *    *    *    *    *    *    *    *    *    *    *    *    *    *    *    50   51   55   74   81   75   68   70   15   0    0    0    0    0    0    0    0    0    0    0   [s]  [s]  [s]   0    0    0    0    0    0    0    73   92   80   58   52   50   *    *    *    *    *    *    *  
  *    *    *    *    *    *    *    *    *    *    *    *    *    *    *    51   54   63   78   82   75   78   76   7    0    0    0    0    0    0    0    0    0    0    0    0    0    0    0    0    0    0    0    0    0    0    39   86   90   76   56   50   *    *    *    *    *    *    *  
  *    *    *    *    *    *    *    *    *    *    *    *    *    *    50   55   58   69   85   86   40   61   87   56   10   0    0    0    0    0    0    0    0    0    0    0    0    0    0    0    0    0    0    0    0    0    2    57   87   89   67   51   *    *    *    *    *    *    *  
  *    *    *    *    *    *    *    *    *    *    *    *    50   49   47   53   58   60   78   90   53   40   80   91   23   0    0    0    0    0    0    0    0    0    0    0    0    0    0    0    0    0    0    0    0    0    0    9    67   90   82   57   *    *    *    *    *    *    *  
  *    *    *    *    *    *    *    *    *    *    50   50   52   47   43   49   47   51   56   76   81   59   68   89   85   17   0    0    0    0    0    0    0    0    0    0    0    0    0    0    0    0    0    0    0    0    0    0    26   83   91   67   50   *    *    *    *    *    *  
  *    *    *    *    *    *    *    *    50   50   49   48   50   46   49   49   49   50   50   50   51   50   52   78   91   77   16   0    0    0    0    0    0    0    0    0    0    0    0    0    0    0    0    0    0    0    0    0    0    75   91   72   51   50   *    *    *    *    *  
  *    *    *    *    *    *    50   50   49   48   45   44   44   48   50   50   50   *    *    *    *    *    *    57   82   91   45   0    0    0    0    0    0    0    0    0    0    0    0    0    0    0    0    0    0    0    0    0    27   84   91   72   52   51   *    *    *    *    *  
  *    *    *    *    *    *    50   49   45   44   44   48   49   50   *    *    *    *    *    *    *    *    *    50   61   84   91   33   0    0    0    0    0    0    0    0    0    0    0    0    0    0    0    0    0    0    0    0    55   91   85   63   *    *    *    *    *    *    *  
  *    *    *    *    *    50   56   49   44   47   49   50   *    *    *    *    *    *    *    *    *    *    *    *    *    70   89   88   20   0    0    0    0    0    0    0    0    0    0    0    0    0    0    0    0    0    0    0    58   91   79   56   *    *    *    *    *    *    *  
  *    *    *    *    *    54   51   51   49   50   *    *    *    *    *    *    *    *    *    *    *    *    *    *    *    50   77   90   83   18   0    0    0    0    0    0    0    0    0    0    0    0    0    0    0    0    0    0    61   91   78   54   50   *    *    *    *    *    *  
  *    *    *    *    *    *    *    *    *    *    *    *    *    *    *    *    *    *    *    *    *    *    *    *    *    *    62   81   90   62   7    0    0    0    0    0    0    0    0    0    0    0    0    0    0    0    0    0    60   91   73   51   50   50   *    *    *    *    *  
  *    *    *    *    *    *    *    *    *    *    *    *    *    *    *    *    *    *    *    *    *    *    *    *    *    *    51   60   83   91   48   10   0    0    0    0    0    0    0    0    0    0    0    0    0    0    0    0    57   91   72   51   51   51   *    *    *    *    *  
  *    *    *    *    *    *    *    *    *    *    *    *    *    *    *    *    *    *    *    *    *    *    *    *    *    *    *    *    63   85   91   39   3    0    0    0    0    0    0    0    0    0    0    0    0    0    0    0    58   90   72   53   50   *    *    *    *    *    *  
  *    *    *    *    *    *    *    *    *    *    *    *    *    *    *    *    *    *    *    *    *    *    *    *    *    *    *    *    *    70   88   85   30   0    0    0    0    0    0    0    0    0    0    0    0    0    0    0    69   90   70   51   *    *    *    *    *    *    *  
  *    *    *    *    *    *    *    *    *    *    *    *    *    *    *    *    *    *    *    *    *    *    *    *    *    *    *    *    *    56   79   90   85   28   0    0    0    0    0    0    0    0    0    0    0    0    0    6    78   89   69   51   *    *    *    *    *    *    *  
  *    *    *    *    *    *    *    *    *    *    *    *    *    *    *    *    *    *    *    *    *    *    *    *    *    *    *    *    *    *    60   81   89   58   19   0    0    0    0    0    0    0    0    0    0    0    0    41   84   83   65   51   *    *    *    *    *    *    *  
  *    *    *    *    *    *    *    *    *    *    *    *    *    *    *    *    *    *    *    *    *    *    *    *    *    *    *    *    *    *    51   63   83   91   51   16   0    0    0    0    0    0    0    0    0    0    0    41   82   80   60   *    *    *    *    *    *    *    *  
  *    *    *    *    *    *    *    *    *    *    *    *    *    *    *    *    *    *    *    *    *    *    *    *    *    *    *    *    *    *    *    54   70   85   87   38   5    0    0    0    0    0    0    0    0    0    0    41   88   75   56   *    *    *    *    *    *    *    *  
  *    *    *    *    *    *    *    *    *    *    *    *    *    *    *    *    *    *    *    *    *    *    *    *    *    *    *    *    *    *    *    *    55   78   89   78   24   7    0    0    0    0    0    0    0    0    0    51   86   76   59   *    *    *    *    *    *    *    *  
  *    *    *    *    *    *    *    *    *    *    *    *    *    *    *    *    *    *    *    *    *    *    *    *    *    *    *    *    *    *    *    *    *    59   81   90   76   31   0    0    0    0    0    0    0    0    37   76   85   78   56   50   *    *    *    *    *    *    *  
  *    *    *    *    *    *    *    *    *    *    *    *    *    *    *    *    *    *    *    *    *    *    *    *    *    *    *    *    *    *    *    *    *    *    63   83   90   58   24   0    0    0    0    0    34   68   88   93   89   73   53   51   *    *    *    *    *    *    *  
  *    *    *    *    *    *    *    *    *    *    *    *    *    *    *    *    *    *    *    *    *    *    *    *    *    *    *    *    *    *    *    *    *    *    49   69   86   89   49   7    0    0    23   64   86   91   91   86   71   56   50   *    *    *    *    *    *    *    *  
  *    *    *    *    *    *    *    *    *    *    *    *    *    *    *    *    *    *    *    *    *    *    *    *    *    *    *    *    *    *    *    *    *    53   54   55   76   87   88   78   75   81   89   92   91   87   76   57   51   51   50   *    *    *    *    *    *    *    *  
  *    *    *    *    *    *    *    *    *    *    *    *    *    *    *    *    *    *    *    *    *    *    *    *    *    *    *    *    *    *    *    *    *    56   60   64   71   82   87   89   92   92   89   82   70   56   49   51   51   51   50   *    *    *    *    *    *    *    *  
  *    *    *    *    *    *    *    *    *    *    *    *    *    *    *    *    *    *    *    *    *    *    *    *    *    *    *    *    *    *    *    *    *    51   54   58   65   76   84   88   85   76   60   52   52   *    50   51   50   *    *    *    *    *    *    *    *    *    *  
  *    *    *    *    *    *    *    *    *    *    *    *    *    *    *    *    *    *    *    *    *    *    *    *    *    *    *    *    *    *    *    *    *    *    *    *    53   67   74   69   59   53   50   *    *    *    *    *    *    *    *    *    *    *    *    *    *    *    *  
  *    *    *    *    *    *    *    *    *    *    *    *    *    *    *    *    *    *    *    *    *    *    *    *    *    *    *    *    *    *    *    *    *    *    *    *    *    51   58   61   54   52   51   *    *    *    *    *    *    *    *    *    *    *    *    *    *    *    *  
  *    *    *    *    *    *    *    *    *    *    *    *    *    *    *    *    *    *    *    *    *    *    *    *    *    *    *    *    *    *    *    *    *    *    *    *    *    *    50   53   51   51   50   *    *    *    *    *    *    *    *    *    *    *    *    *    *    *    *  
  *    *    *    *    *    *    *    *    *    *    *    *    *    *    *    *    *    *    *    *    *    *    *    *    *    *    *    *    *    *    *    *    *    *    *    *    *    *    *    52   51   *    *    *    *    *    *    *    *    *    *    *    *    *    *    *    *    *    *  
  *    *    *    *    *    *    *    *    *    *    *    *    *    *    *    *    *    *    *    *    *    *    *    *    *    *    *    *    *    *    *    *    *    *    *    *    *    *    *    *    *    *    *    *    *    *    *    *    *    *    *    *    *    *    *    *    *    *    *  
  *    *    *    *    *    *    *    *    *    *    *    *    *    *    *    *    *    *    *    *    *    *    *    *    *    *    *    *    *    *    *    *    *    *    *    *    *    *    *    *    *    *    *    *    *    *    *    *    *    *    *    *    *    *    *    *    *    *    *  
  *    *    *    *    *    *    *    *    *    *    *    *    *    *    *    *    *    *    *    *    *    *    *    *    *    *    *    *    *    *    *    *    *    *    *    *    *    *    *    *    *    *    *    *    *    *    *    *    *    *    *    *    *    *    *    *    *    *    *  
  *    *    *    *    *    *    *    *    *    *    *    *    *    *    *    *    *    *    *    *    *    *    *    *    *    *    *    *    *    *    *    *    *    *    *    *    *    *    *    *    *    *    *    *    *    *    *    *    *    *    *    *    *    *    *    *    *    *    *  
  *    *    *    *    *    *    *    *    *    *    *    *    *    *    *    *    *    *    *    *    *    *    *    *    *    *    *    *    *    *    *    *    *    *    *    *    *    *    *    *    *    *    *    *    *    *    *    *    *    *    *    *    *    *    *    *    *    *    *  
